wwwwwwwwwwwwwwww
w..............w
w.www.www.ww.w.w
w.www.www.ww.w.w
wA......w.....xw
w.www.w.wwww.www
w.......wwww.www
w..............w
wwwwwwwwwwwwwwww
